"filename", "language", "Gradle", "Java Properties", "XML", "Dart", "comment", "blank", "total"
"c:\Users\User\CODE\mobile_apps\presenter_2\android\app\build.gradle", "Gradle", 54, 0, 0, 0, 5, 13, 72
"c:\Users\User\CODE\mobile_apps\presenter_2\android\app\src\debug\AndroidManifest.xml", "XML", 0, 0, 4, 0, 4, 1, 9
"c:\Users\User\CODE\mobile_apps\presenter_2\android\app\src\main\AndroidManifest.xml", "XML", 0, 0, 28, 0, 6, 1, 35
"c:\Users\User\CODE\mobile_apps\presenter_2\android\app\src\main\res\drawable-v21\launch_background.xml", "XML", 0, 0, 4, 0, 7, 2, 13
"c:\Users\User\CODE\mobile_apps\presenter_2\android\app\src\main\res\drawable\launch_background.xml", "XML", 0, 0, 4, 0, 7, 2, 13
"c:\Users\User\CODE\mobile_apps\presenter_2\android\app\src\main\res\values-night\styles.xml", "XML", 0, 0, 9, 0, 9, 1, 19
"c:\Users\User\CODE\mobile_apps\presenter_2\android\app\src\main\res\values\styles.xml", "XML", 0, 0, 9, 0, 9, 1, 19
"c:\Users\User\CODE\mobile_apps\presenter_2\android\app\src\profile\AndroidManifest.xml", "XML", 0, 0, 4, 0, 4, 1, 9
"c:\Users\User\CODE\mobile_apps\presenter_2\android\build.gradle", "Gradle", 27, 0, 0, 0, 0, 5, 32
"c:\Users\User\CODE\mobile_apps\presenter_2\android\gradle.properties", "Java Properties", 0, 3, 0, 0, 0, 1, 4
"c:\Users\User\CODE\mobile_apps\presenter_2\android\gradle\wrapper\gradle-wrapper.properties", "Java Properties", 0, 5, 0, 0, 0, 1, 6
"c:\Users\User\CODE\mobile_apps\presenter_2\android\settings.gradle", "Gradle", 8, 0, 0, 0, 0, 4, 12
"c:\Users\User\CODE\mobile_apps\presenter_2\lib\design.dart", "Dart", 0, 0, 0, -63, -3, -26, -92
"c:\Users\User\CODE\mobile_apps\presenter_2\lib\home.dart", "Dart", 0, 0, 0, -213, -81, -9, -303
"c:\Users\User\CODE\mobile_apps\presenter_2\lib\main.dart", "Dart", 0, 0, 0, -104, -8, -19, -131
"c:\Users\User\CODE\mobile_apps\presenter_2\lib\presenter.dart", "Dart", 0, 0, 0, -211, -4, -19, -234
"Total", "-", 89, 8, 62, -591, -45, -40, -517