"filename", "language", "Markdown", "Dart", "comment", "blank", "total"
"c:\Users\User\CODE\mobile_apps\A_Better_Presenter\A-Better-Presenter-Mobile\lib\README.md", "Markdown", 5, 0, 0, 1, 6
"c:\Users\User\CODE\mobile_apps\A_Better_Presenter\A-Better-Presenter-Mobile\lib\design.dart", "Dart", 0, 253, 3, 49, 305
"c:\Users\User\CODE\mobile_apps\A_Better_Presenter\A-Better-Presenter-Mobile\lib\help.dart", "Dart", 0, 382, 3, 44, 429
"c:\Users\User\CODE\mobile_apps\A_Better_Presenter\A-Better-Presenter-Mobile\lib\home.dart", "Dart", 0, 707, 1, 21, 729
"c:\Users\User\CODE\mobile_apps\A_Better_Presenter\A-Better-Presenter-Mobile\lib\main.dart", "Dart", 0, 95, 11, 19, 125
"c:\Users\User\CODE\mobile_apps\A_Better_Presenter\A-Better-Presenter-Mobile\lib\presenter.dart", "Dart", 0, 700, 3, 51, 754
"c:\Users\User\CODE\mobile_apps\A_Better_Presenter\A-Better-Presenter-Mobile\lib\store.dart", "Dart", 0, 61, 4, 21, 86
"c:\Users\User\CODE\mobile_apps\A_Better_Presenter\A-Better-Presenter-Mobile\lib\test.md", "Markdown", 9, 0, 0, 0, 9
"c:\Users\User\CODE\mobile_apps\A_Better_Presenter\A-Better-Presenter-Mobile\lib\wifi.dart", "Dart", 0, 77, 0, 15, 92
"Total", "-", 14, 2275, 25, 221, 2535