"filename", "language", "Dart", "Markdown", "comment", "blank", "total"
"c:\Users\User\CODE\mobile_apps\A_Better_Presenter\A-Better-Presenter-Mobile\lib\README.md", "Markdown", 0, 1, 0, 1, 2
"c:\Users\User\CODE\mobile_apps\A_Better_Presenter\A-Better-Presenter-Mobile\lib\STORE.dart", "Dart", -56, 0, -20, -17, -93
"c:\Users\User\CODE\mobile_apps\A_Better_Presenter\A-Better-Presenter-Mobile\lib\_ble.dart", "Dart", 0, 0, 298, 2, 300
"c:\Users\User\CODE\mobile_apps\A_Better_Presenter\A-Better-Presenter-Mobile\lib\_promo.dart", "Dart", 129, 0, 0, 13, 142
"c:\Users\User\CODE\mobile_apps\A_Better_Presenter\A-Better-Presenter-Mobile\lib\components.dart", "Dart", -73, 0, -2, -15, -90
"c:\Users\User\CODE\mobile_apps\A_Better_Presenter\A-Better-Presenter-Mobile\lib\control.dart", "Dart", -19, 0, -27, -10, -56
"c:\Users\User\CODE\mobile_apps\A_Better_Presenter\A-Better-Presenter-Mobile\lib\design.dart", "Dart", 163, 0, 0, 14, 177
"c:\Users\User\CODE\mobile_apps\A_Better_Presenter\A-Better-Presenter-Mobile\lib\editor.dart", "Dart", -77, 0, -22, -8, -107
"c:\Users\User\CODE\mobile_apps\A_Better_Presenter\A-Better-Presenter-Mobile\lib\help.dart", "Dart", 264, 0, -20, 29, 273
"c:\Users\User\CODE\mobile_apps\A_Better_Presenter\A-Better-Presenter-Mobile\lib\home.dart", "Dart", 504, 0, 183, 11, 698
"c:\Users\User\CODE\mobile_apps\A_Better_Presenter\A-Better-Presenter-Mobile\lib\main.dart", "Dart", 11, 0, -16, 0, -5
"c:\Users\User\CODE\mobile_apps\A_Better_Presenter\A-Better-Presenter-Mobile\lib\presenter.dart", "Dart", 434, 0, -7, 29, 456
"c:\Users\User\CODE\mobile_apps\A_Better_Presenter\A-Better-Presenter-Mobile\lib\store.dart", "Dart", 61, 0, 4, 21, 86
"c:\Users\User\CODE\mobile_apps\A_Better_Presenter\A-Better-Presenter-Mobile\lib\wifi.dart", "Dart", 77, 0, 0, 15, 92
"Total", "-", 1418, 1, 371, 85, 1875